3
VVH
HHV
VVH
HHH
VVV
2
VV
HV
VH
3
VVH
HHV
VVV
HHH
VHH
10 
VVVHHHVVVH
HHVHVHVHVH
VHVHVHVHVH
VHVHHHVHVH
VHVHVHHVHV
HVHHHVHVHV
HVHVHVHVHV
HVHVHVHVHV
HVHVHHHHVH
VHVHVHVHVH
VHVHVHVHVH
VHVHVHVHVH
VHVHVHVHVH
VHVHVHVHVH
VHVHVHVHVH
VHVHVHVHVH
HHHVHVHVHV
HHHVHVVVVV
HHHVHVVVVV
5
VHHVH
VHHVH
VHVHV
HVVVH
VHHVV
VVHVV
VHVHV
HVHVH
VHVHV